==========
=######===
=# X X#===
=# CC  ##=
=##  E  #=  
===#    #=
===#   ##=
===#####== 
==========
==========