==========
=#####====
## E ####=
#     X ##
# #      #
# CC  X  #
##    ####
=##   #=== 
==#####===
==========